20
20
####################
####_########_####_#
#_###_##____##__##_#
#__#__#__#_#___#_#_#
##_##__##_########_#
#_____#____#_____#1#
#####_###_###_##_#_#
####_##__#___#####_#
#_##__##_#_#___###_#
#___####___###___#_#
#_##_##__#_#___###_#
#_#__####_###_###__#
####_##____###_###F#
#_____#####_######_#
##_####_#_#__#_#_#_#
#_____#_____#____#_#
###_################
##__#_##_#_#___#___#
#__#______#__#__#_##
####################
