20
20
####################
#_#___###_##_F___#_#
#_##_#####_#_###_#1#
#_##_###____#__#___#
#_____#_##_#__##_#_#
#_#####_####_#######
#_#__##____###_#___#
#__#__####_#_#_##_##
####_###_#_##___##_#
#_#___##__#####_#__#
#_###_####_#########
#________#_##_#__#_#
#_###_#_##_#__#_##_#
#_#___##____#_#_##_#
###_###__####_#_#__#
#____##_#####_####_#
#_##__#__###_#_#___#
#_#__##_####_##__#_#
#################_##
####################
